word:catch	freq:2
word:such	freq:1
word:strength	freq:1
word:misconsterd	freq:1
word:vaste	freq:1
word:will	freq:2
word:officer	freq:1
word:leysures	freq:1
word:frowning	freq:2
word:chosen	freq:1
word:gentlemen	freq:1
word:sauing	freq:2
word:barbarous	freq:1
word:wilt	freq:6
word:ours	freq:2
word:fairenesse	freq:1
word:weake	freq:1
word:come	freq:7
word:appeareth	freq:1
word:arragon	freq:1
word:neighbours	freq:1
word:headed	freq:1
word:made	freq:17
word:wither	freq:1
word:bettred	freq:1
word:night	freq:34
word:giuing	freq:2
word:iacks	freq:1
word:weaker	freq:1
word:doubtfull	freq:2
word:intreat	freq:3
word:dispach	freq:1
word:offices	freq:3
word:flatly	freq:1
word:cursed	freq:2
word:nominated	freq:2
word:bassiano	freq:1
word:bounds	freq:1
word:price	freq:2
word:quarreling	freq:1
word:stratagems	freq:1
word:thousand	freq:22
word:weakest	freq:1
word:afraid	freq:1
word:trifle	freq:3
word:cities	freq:1
word:bedfellow	freq:2
word:enemies	freq:1
word:ianus	freq:1
word:monastery	freq:1
word:next	freq:5
word:furnished	freq:1
word:wine	freq:3
word:straight	freq:1
word:pillar	freq:1
word:diana	freq:1
word:once	freq:7
word:drinke	freq:1
word:smug	freq:1
word:measures	freq:1
word:begot	freq:1
word:sharpe	freq:1
word:sunder	freq:1
word:happiest	freq:1
word:friendly	freq:1
word:parcell	freq:1
word:wins	freq:1
word:abundance	freq:1
word:rare	freq:2
word:tongue	freq:7
word:likenes	freq:1
word:rauenous	freq:1
word:lights	freq:1
word:record	freq:1
word:payes	freq:1
word:hagars	freq:1
word:vnderstand	freq:6
word:valew	freq:3
word:ribs	freq:3
word:pries	freq:1
word:paund	freq:1
word:cholchos	freq:1
word:clo	freq:1
word:firme	freq:1
word:nerryssa	freq:1
word:dead	freq:5
word:straite	freq:1
word:beleeue	freq:3
word:lancelet	freq:1
word:complexion	freq:4
word:daie	freq:3
word:lyuers	freq:1
word:exposition	freq:1
word:lawful	freq:1
word:houre	freq:7
word:infus	freq:1
word:expect	freq:5
word:rich	freq:9
word:stayers	freq:1
word:rash	freq:1
word:harmlesse	freq:1
word:messengers	freq:1
word:cope	freq:1
word:fearefull	freq:1
word:namest	freq:1
word:touching	freq:1
word:trie	freq:2
word:countri	freq:1
word:marry	freq:1
word:nephew	freq:1
word:badge	freq:1
word:shallows	freq:1
word:long	freq:7
word:villanie	freq:1
word:attentiue	freq:1
word:get	freq:2
word:stomacks	freq:1
word:torch	freq:2
word:early	freq:1
word:earliest	freq:1
word:knocks	freq:1
word:vnder	freq:6
word:stomacke	freq:1
word:coniured	freq:1
word:beards	freq:1
word:house	freq:24
word:grose	freq:1
word:worship	freq:5
word:iacob	freq:1
word:rate	freq:3
word:pricke	freq:1
word:seald	freq:1
word:seale	freq:5
word:demand	freq:1
word:iewels	freq:4
word:within	freq:1
word:goest	freq:2
word:whereof	freq:2
word:carcasses	freq:1
word:moode	freq:1
word:rats	freq:2
word:hauing	freq:4
word:houses	freq:1
word:labour	freq:1
word:outward	freq:3
word:iacobs	freq:1
word:rob	freq:1
word:inspirations	freq:1
word:look	freq:4
word:creditors	freq:1
word:times	freq:15
word:seede	freq:1
word:brow	freq:2
word:bearer	freq:3
word:beares	freq:3
word:sonties	freq:1
word:magnificoes	freq:1
word:debt	freq:3
word:mislike	freq:1
word:withstanding	freq:1
word:scorned	freq:1
word:mother	freq:6
word:admit	freq:1
word:saile	freq:2
word:master	freq:2
word:comments	freq:1
word:fram	freq:1
word:maid	freq:4
word:abiect	freq:1
word:venture	freq:3
word:peize	freq:1
word:warrantie	freq:1
word:cooling	freq:1
word:venecian	freq:1
word:oration	freq:1
word:performe	freq:1
word:choose	freq:28
word:damnation	freq:1
word:fray	freq:1
word:quicken	freq:1
word:demie	freq:1
word:meat	freq:2
word:sober	freq:4
word:rend	freq:1
word:twixt	freq:1
word:layes	freq:1
word:bright	freq:2
word:snaile	freq:1
word:season	freq:4
word:commer	freq:1
word:kisse	freq:5
word:gods	freq:1
word:writing	freq:2
word:mightiest	freq:2
word:cost	freq:2
word:siluer	freq:1
word:deliuered	freq:1
word:venice	freq:1
word:rent	freq:1
word:maddam	freq:1
word:wroath	freq:1
word:pitty	freq:2
word:pearce	freq:1
word:wise	freq:9
word:corruptly	freq:1
word:deed	freq:6
word:wish	freq:14
word:offenders	freq:1
word:swear	freq:1
word:bellie	freq:1
word:incision	freq:1
word:interposer	freq:1
word:perhaps	freq:1
word:stilnesse	freq:1
word:plots	freq:1
word:damn	freq:3
word:stockish	freq:1
word:albeit	freq:1
word:fleece	freq:3
word:ingratitude	freq:1
word:weare	freq:8
word:falsehood	freq:1
word:goes	freq:2
word:makes	freq:9
word:suger	freq:1
word:make	freq:11
word:curbe	freq:1
word:pause	freq:4
word:lord	freq:1
word:widdowes	freq:2
word:companie	freq:2
word:inscrold	freq:1
word:cord	freq:1
word:saint	freq:1
word:spoyles	freq:1
word:with	freq:7
word:forgot	freq:1
word:sternest	freq:1
word:obiect	freq:1
word:crost	freq:1
word:steales	freq:1
word:limbs	freq:1
word:visite	freq:1
word:suters	freq:1
word:smiling	freq:1
word:nations	freq:1
word:faithfully	freq:1
word:gramercie	freq:1
word:gainst	freq:3
word:trip	freq:1
word:speaking	freq:1
word:confiscate	freq:2
word:present	freq:9
word:prest	freq:1
word:temper	freq:1
word:gouernour	freq:1
word:meaning	freq:3
word:wiue	freq:1
word:impossible	freq:1
word:first	freq:6
word:orbe	freq:1
word:height	freq:1
word:forraine	freq:1
word:iess	freq:1
word:iest	freq:1
word:cry	freq:1
word:torturer	freq:1
word:lost	freq:7
word:yeeres	freq:1
word:weele	freq:2
word:free	freq:1
word:mercy	freq:8
word:lose	freq:2
word:whole	freq:3
word:rehearst	freq:1
word:sworne	freq:5
word:comes	freq:5
word:chased	freq:1
word:penalties	freq:2
word:candle	freq:3
word:wouen	freq:2
word:publique	freq:1
word:streete	freq:1
word:dislike	freq:1
word:poet	freq:1
word:troy	freq:1
word:sums	freq:1
word:beautious	freq:1
word:edifice	freq:1
word:streets	freq:1
word:mercifull	freq:2
word:commit	freq:2
word:rul	freq:1
word:nourished	freq:1
word:beseech	freq:7
word:run	freq:10
word:loud	freq:2
word:loue	freq:1
word:attend	freq:2
word:resemble	freq:1
word:quick	freq:2
word:amity	freq:1
word:currant	freq:1
word:minde	freq:17
word:burnisht	freq:1
word:mans	freq:6
word:richly	freq:3
word:sweet	freq:1
word:daring	freq:1
word:many	freq:9
word:offended	freq:1
word:earth	freq:5
word:seeke	freq:7
word:dayes	freq:1
word:drosse	freq:1
word:linger	freq:1
word:alablaster	freq:1
word:lords	freq:1
word:solanio	freq:1
word:diamond	freq:1
word:despise	freq:1
word:wondrous	freq:2
word:burthens	freq:1
word:rest	freq:11
word:euen	freq:2
word:enough	freq:10
word:poison	freq:1
word:cut	freq:11
word:euer	freq:12
word:dare	freq:4
word:leuen	freq:1
word:fawning	freq:1
word:betimes	freq:1
word:producing	freq:1
word:gobbe	freq:1
word:suffrance	freq:1
word:attaine	freq:1
word:subiects	freq:1
word:vnfurnisht	freq:1
word:key	freq:3
word:weigh	freq:2
word:loren	freq:1
word:sealed	freq:2
word:proceeding	freq:1
word:instructions	freq:1
word:leuell	freq:1
word:iewell	freq:1
word:birth	freq:1
word:ayme	freq:1
word:iewe	freq:1
word:sayest	freq:1
word:branches	freq:1
word:detaine	freq:1
word:beheld	freq:1
word:plucking	freq:1
word:vow	freq:2
word:imposition	freq:2
word:dice	freq:1
word:grosly	freq:1
word:inland	freq:1
word:maps	freq:1
word:custome	freq:2
word:remembrance	freq:1
word:aboue	freq:4
word:tripolis	freq:1
word:cuckolds	freq:1
word:scanted	freq:1
word:dreadfull	freq:1
word:gob	freq:1
word:vpon	freq:5
word:seeme	freq:1
word:immur	freq:1
word:chin	freq:1
word:god	freq:1
word:goe	freq:5
word:publish	freq:1
word:about	freq:1
word:kingdome	freq:1
word:ought	freq:5
word:growes	freq:3
word:clowne	freq:1
word:alter	freq:2
word:got	freq:6
word:lands	freq:1
word:empties	freq:1
word:conuenient	freq:1
word:gold	freq:1
word:sinfull	freq:1
word:proportion	freq:1
word:shines	freq:3
word:memory	freq:1
word:dido	freq:1
word:ring	freq:5
word:drowne	freq:1
word:moone	freq:1
word:seene	freq:4
word:partlie	freq:1
word:gloues	freq:1
word:shone	freq:1
word:tribute	freq:2
word:newes	freq:13
word:dobbin	freq:1
word:offer	freq:7
word:containes	freq:3
word:garments	freq:1
word:mark	freq:1
word:cunning	freq:1
word:sure	freq:10
word:prouerbe	freq:2
word:died	freq:1
word:begotten	freq:1
word:porke	freq:1
word:wiuing	freq:1
word:departure	freq:1
word:mart	freq:1
word:mars	freq:1
word:notes	freq:1
word:saying	freq:7
word:accepted	freq:1
word:dies	freq:3
word:temple	freq:1
word:infold	freq:1
word:abridg	freq:1
word:voice	freq:5
word:drawes	freq:1
word:iuorie	freq:1
word:true	freq:24
word:worthy	freq:3
word:mistrust	freq:1
word:kin	freq:1
word:kil	freq:2
word:slinke	freq:1
word:children	freq:1
word:deerely	freq:1
word:commiseration	freq:1
word:ingag	freq:1
word:stilnes	freq:1
word:diest	freq:1
word:shoot	freq:1
word:tutches	freq:2
word:miracle	freq:1
word:gone	freq:14
word:proper	freq:2
word:spices	freq:1
word:memorie	freq:1
word:ripe	freq:1
word:erobus	freq:1
word:throughly	freq:1
word:vsd	freq:1
word:gra	freq:1
word:vse	freq:8
word:voide	freq:2
word:whose	freq:3
word:sibilla	freq:1
word:would	freq:11
word:common	freq:4
word:runner	freq:1
word:deny	freq:7
word:hands	freq:3
word:sceptred	freq:1
word:iealous	freq:1
word:healed	freq:1
word:becomes	freq:1
word:gaine	freq:4
word:sute	freq:2
word:heerein	freq:1
word:shylok	freq:1
word:pythagoras	freq:1
word:chiefest	freq:1
word:impediment	freq:1
word:ballance	freq:1
word:good	freq:7
word:friends	freq:12
word:nought	freq:1
word:aspect	freq:2
word:hereafter	freq:1
word:tranect	freq:1
word:morning	freq:6
word:theefe	freq:2
word:bounty	freq:1
word:standing	freq:1
word:became	freq:1
word:vnkinde	freq:1
word:troylus	freq:1
word:cudgell	freq:1
word:processe	freq:1
word:mortifying	freq:1
word:ayre	freq:3
word:honor	freq:5
word:anie	freq:5
word:disabled	freq:1
word:knapt	freq:1
word:inlayed	freq:1
word:soules	freq:3
word:head	freq:14
word:morrocho	freq:1
word:surgeon	freq:1
word:beset	freq:1
word:blessed	freq:1
word:value	freq:4
word:drest	freq:1
word:eanelings	freq:1
word:leysure	freq:2
word:destenie	freq:1
word:riding	freq:1
word:yoke	freq:1
word:moore	freq:1
word:pierce	freq:1
word:rennish	freq:1
word:pilgrimage	freq:1
word:turkies	freq:1
word:wound	freq:1
word:prodigall	freq:5
word:shore	freq:1
word:merry	freq:6
word:buriall	freq:1
word:pond	freq:1
word:bankrout	freq:2
word:onely	freq:1
word:dores	freq:1
word:discretion	freq:1
word:presence	freq:2
word:short	freq:1
word:mens	freq:1
word:liuories	freq:1
word:spirit	freq:11
word:body	freq:4
word:iewish	freq:1
word:quest	freq:1
word:liuing	freq:2
word:quintus	freq:1
word:natures	freq:1
word:gaping	freq:3
word:enthroned	freq:1
word:transformed	freq:1
word:grosse	freq:2
word:fathers	freq:1
word:eyed	freq:2
word:specifie	freq:2
word:from	freq:1
word:ashwensday	freq:1
word:soule	freq:15
word:locks	freq:2
word:lockt	freq:1
word:wauer	freq:1
word:lordship	freq:1
word:geare	freq:1
word:thought	freq:9
word:goates	freq:1
word:dooing	freq:1
word:certaine	freq:6
word:eyes	freq:14
word:muttons	freq:1
word:swift	freq:1
word:fetching	freq:1
word:eaters	freq:1
word:appropriation	freq:1
word:thither	freq:1
word:pleaseth	freq:1
word:their	freq:4
word:enacted	freq:1
word:sucking	freq:1
word:vniuersall	freq:1
word:off	freq:10
word:madam	freq:1
word:aduantages	freq:1
word:report	freq:1
word:moytie	freq:1
word:keene	freq:3
word:view	freq:5
word:sommer	freq:1
word:seaze	freq:1
word:oft	freq:3
word:hayre	freq:1
word:necessity	freq:1
word:hedg	freq:1
word:fauour	freq:2
word:simplicitie	freq:1
word:discouer	freq:1
word:sandie	freq:1
word:aduis	freq:2
word:rated	freq:2
word:hall	freq:1
word:vertuous	freq:1
word:corrupt	freq:1
word:shoote	freq:1
word:yond	freq:2
word:perfection	freq:1
word:yong	freq:9
word:wretch	freq:1
word:strai	freq:1
word:thankfully	freq:2
word:mingled	freq:1
word:termes	freq:1
word:notarie	freq:1
word:sound	freq:5
word:knell	freq:1
word:conduct	freq:1
word:vnfold	freq:1
word:limpe	freq:1
word:trumpet	freq:1
word:inforc	freq:1
word:heed	freq:1
word:leaden	freq:1
word:tricksie	freq:1
word:stray	freq:1
word:shout	freq:1
word:falls	freq:1
word:hanging	freq:1
word:lyons	freq:1
word:cripple	freq:1
word:dinner	freq:11
word:bought	freq:5
word:pennie	freq:1
word:bushels	freq:1
word:obseruance	freq:1
word:knaue	freq:2
word:grace	freq:1
word:ducate	freq:1
word:fooling	freq:1
word:conceit	freq:2
word:enemie	freq:2
word:entred	freq:1
word:chooses	freq:2
word:deerest	freq:1
word:gratiano	freq:1
word:keepe	freq:9
word:showes	freq:2
word:scholler	freq:1
word:commandement	freq:2
word:ducats	freq:1
word:alien	freq:1
word:hand	freq:22
word:trades	freq:1
word:hang	freq:4
word:bassanio	freq:1
word:defie	freq:1
word:port	freq:2
word:fortnight	freq:1
word:counterfeit	freq:1
word:prize	freq:2
word:already	freq:2
word:sad	freq:9
word:visitation	freq:1
word:maisters	freq:1
word:knife	freq:4
word:presages	freq:1
word:curre	freq:3
word:sal	freq:1
word:monkie	freq:1
word:showe	freq:1
word:mesh	freq:1
word:standst	freq:1
word:falne	freq:1
word:tempts	freq:1
word:quaint	freq:1
word:scarce	freq:3
word:saw	freq:5
word:dine	freq:1
word:say	freq:5
word:ding	freq:1
word:place	freq:10
word:worthlesse	freq:1
word:pagan	freq:1
word:acceptance	freq:1
word:blunt	freq:1
word:post	freq:1
word:forfaite	freq:2
word:horne	freq:1
word:publican	freq:1
word:kindnesse	freq:3
word:forbeare	freq:1
word:swelling	freq:1
word:humility	freq:1
word:mantle	freq:1
word:ports	freq:1
word:sau	freq:1
word:mutuall	freq:1
word:curse	freq:1
word:gallowes	freq:2
word:towards	freq:2
word:mittigate	freq:1
word:chaste	freq:1
word:friendship	freq:2
word:dam	freq:3
word:dardanian	freq:1
word:measure	freq:2
word:dementions	freq:1
word:frowne	freq:1
word:parke	freq:1
word:gnats	freq:1
word:dewe	freq:1
word:cuckold	freq:1
word:day	freq:24
word:afore	freq:1
word:scorne	freq:1
word:accept	freq:2
word:satisfaction	freq:1
word:scruple	freq:1
word:diseases	freq:1
word:temptation	freq:1
word:patient	freq:1
word:candles	freq:1
word:fruite	freq:1
word:vnfeeling	freq:1
word:principall	freq:3
word:smack	freq:1
word:vendible	freq:1
word:though	freq:1
word:sophie	freq:1
word:chus	freq:1
word:debating	freq:1
word:throate	freq:1
word:pocket	freq:1
word:weight	freq:2
word:very	freq:12
word:couer	freq:4
word:packe	freq:1
word:tricks	freq:1
word:docks	freq:1
word:impertinent	freq:1
word:displeas	freq:1
word:torture	freq:1
word:balthazar	freq:1
word:burning	freq:1
word:mistresse	freq:1
word:command	freq:1
word:dearest	freq:1
word:sweetest	freq:1
word:compulsion	freq:1
word:indebted	freq:1
word:old	freq:22
word:bold	freq:3
word:expressing	freq:1
word:rammes	freq:1
word:vnlesse	freq:1
word:debts	freq:3
word:apparant	freq:1
word:mine	freq:14
word:welfare	freq:1
word:lorens	freq:1
word:shallow	freq:1
word:enformed	freq:1
word:scarfe	freq:1
word:hard	freq:5
word:hare	freq:1
word:proclamation	freq:1
word:reasonable	freq:1
word:womans	freq:1
word:liuer	freq:1
word:vile	freq:2
word:brought	freq:1
word:liues	freq:2
word:sea	freq:3
word:embassador	freq:1
word:actus	freq:1
word:reach	freq:1
word:see	freq:40
word:acquainted	freq:3
word:hart	freq:1
word:foolish	freq:2
word:apple	freq:1
word:beautie	freq:2
word:garnisht	freq:1
word:driue	freq:2
word:mounted	freq:1
word:euery	freq:9
word:clow	freq:1
word:ser	freq:1
word:tedious	freq:2
word:set	freq:6
word:larke	freq:1
word:quite	freq:1
word:wishes	freq:1
word:morrow	freq:2
word:trybe	freq:1
word:secretly	freq:1
word:glad	freq:8
word:rude	freq:2
word:praising	freq:2
word:reade	freq:4
word:seated	freq:1
word:lends	freq:2
word:bond	freq:40
word:bone	freq:1
word:viands	freq:1
word:one	freq:6
word:farthest	freq:1
word:pages	freq:1
word:false	freq:3
word:answere	freq:5
word:lady	freq:1
word:competencie	freq:1
word:your	freq:16
word:opinion	freq:6
word:anth	freq:1
word:extend	freq:2
word:hast	freq:5
word:great	freq:7
word:held	freq:2
word:hate	freq:3
word:lacke	freq:4
word:wednesday	freq:1
word:dish	freq:1
word:maske	freq:2
word:grasse	freq:1
word:hath	freq:3
word:hell	freq:3
word:consequence	freq:1
word:answers	freq:1
word:horse	freq:3
word:euill	freq:2
word:there	freq:2
word:length	freq:1
word:iessica	freq:1
word:respect	freq:3
word:blush	freq:1
word:dogge	freq:3
word:wormes	freq:1
word:genowa	freq:1
word:snow	freq:1
word:incur	freq:1
word:circumstance	freq:1
word:hollow	freq:1
word:flatter	freq:1
word:valors	freq:1
word:infection	freq:1
word:honours	freq:1
word:defendant	freq:1
word:these	freq:5
word:acknowledge	freq:1
word:plaid	freq:1
word:hence	freq:6
word:plaie	freq:1
word:moreouer	freq:1
word:teares	freq:3
word:tarry	freq:2
word:zeale	freq:1
word:haue	freq:19
word:bestowed	freq:2
word:tiranny	freq:1
word:ready	freq:4
word:constant	freq:2
word:hier	freq:1
word:creation	freq:1
word:pleas	freq:4
word:she	freq:18
word:ope	freq:2
word:presse	freq:2
word:before	freq:7
word:slightly	freq:1
word:queene	freq:1
word:vertue	freq:3
word:leonardo	freq:1
word:basket	freq:1
word:truly	freq:1
word:immortall	freq:1
word:qualities	freq:1
word:sayes	freq:2
word:bestowes	freq:1
word:runne	freq:5
word:intermission	freq:1
word:strange	freq:7
word:shy	freq:1
word:pallaces	freq:1
word:messages	freq:1
word:conuerted	freq:1
word:fates	freq:1
word:clock	freq:1
word:shoulders	freq:1
word:casements	freq:2
word:stolne	freq:1
word:fading	freq:1
word:vnlike	freq:2
word:play	freq:1
word:fulsome	freq:1
word:vnreasonable	freq:1
word:amitie	freq:1
word:hangmans	freq:1
word:distinct	freq:1
word:witte	freq:2
word:told	freq:12
word:phangs	freq:1
word:sir	freq:1
word:was	freq:28
word:sit	freq:1
word:letter	freq:4
word:signifie	freq:4
word:heeles	freq:2
word:labans	freq:1
word:way	freq:9
word:high	freq:7
word:six	freq:2
word:chose	freq:2
word:could	freq:6
word:bechaunc	freq:1
word:purposes	freq:1
word:braggart	freq:1
word:secret	freq:2
word:oracle	freq:1
word:hearing	freq:2
word:windes	freq:2
word:deceiu	freq:2
word:ore	freq:10
word:had	freq:3
word:did	freq:11
word:die	freq:3
word:might	freq:7
word:deceiued	freq:1
word:describe	freq:1
word:habite	freq:2
word:heated	freq:1
word:cutting	freq:1
word:cuckow	freq:1
word:agitation	freq:1
word:dim	freq:1
word:laughter	freq:1
word:lead	freq:3
word:thine	freq:4
word:has	freq:2
word:hat	freq:1
word:taken	freq:3
word:riuall	freq:1
word:harme	freq:1
word:destinie	freq:1
word:thing	freq:13
word:presentlie	freq:1
word:furnish	freq:3
word:excuse	freq:2
word:crossing	freq:1
word:recant	freq:1
word:cald	freq:1
word:monday	freq:1
word:easie	freq:2
word:shippes	freq:1
word:belario	freq:1
word:stuffe	freq:1
word:balth	freq:1
word:poetry	freq:1
word:call	freq:1
word:ineuitable	freq:1
word:selfesame	freq:2
word:sufficient	freq:2
word:bated	freq:2
word:knewe	freq:1
word:cals	freq:1
word:takes	freq:1
word:mantua	freq:1
word:forthwith	freq:1
word:grant	freq:4
word:rights	freq:2
word:laid	freq:1
word:words	freq:10
word:paines	freq:4
word:leah	freq:1
word:varnisht	freq:2
word:commend	freq:1
word:darke	freq:2
word:parts	freq:4
word:morocho	freq:1
word:miscaried	freq:1
word:currish	freq:2
word:came	freq:1
word:iudgement	freq:9
word:party	freq:2
word:thinkes	freq:4
word:wrest	freq:1
word:fellow	freq:3
word:likely	freq:1
word:twelue	freq:2
word:small	freq:1
word:count	freq:1
word:both	freq:15
word:trassell	freq:1
word:beholdst	freq:1
word:enquire	freq:1
word:vnschool	freq:1
word:plea	freq:4
word:nothing	freq:1
word:sacred	freq:1
word:here	freq:2
word:nerris	freq:1
word:latter	freq:1
word:trouble	freq:2
word:mirth	freq:2
word:tenure	freq:1
word:defended	freq:1
word:bellario	freq:1
word:placed	freq:1
word:ceremoniously	freq:1
word:wee	freq:8
word:frutifie	freq:1
word:visages	freq:2
word:little	freq:12
word:cressed	freq:1
word:hers	freq:1
word:wel	freq:5
word:prettier	freq:1
word:harke	freq:2
word:shadow	freq:4
word:wands	freq:1
word:creep	freq:1
word:our	freq:13
word:out	freq:8
word:quiring	freq:1
word:kindest	freq:1
word:containe	freq:2
word:proceede	freq:1
word:tops	freq:1
word:replie	freq:2
word:constitution	freq:1
word:reede	freq:1
word:secundus	freq:1
word:whither	freq:1
word:wisedome	freq:2
word:smiles	freq:1
word:hee	freq:18
word:frost	freq:1
word:earnestly	freq:1
word:rule	freq:1
word:harder	freq:1
word:impeach	freq:2
word:carries	freq:1
word:ysicles	freq:1
word:third	freq:6
word:her	freq:57
word:tooke	freq:2
word:busines	freq:2
word:receiu	freq:1
word:twentie	freq:5
word:bargaines	freq:2
word:shuddring	freq:1
word:twas	freq:1
word:rume	freq:1
word:diuell	freq:12
word:prepar	freq:1
word:peering	freq:1
word:humors	freq:1
word:mercinarie	freq:1
word:sayle	freq:1
word:vnwearied	freq:1
word:owe	freq:5
word:blacke	freq:1
word:bowe	freq:1
word:trust	freq:2
word:attempt	freq:2
word:sol	freq:1
word:twaine	freq:1
word:son	freq:1
word:noise	freq:1
word:seuer	freq:1
word:som	freq:1
word:layest	freq:1
word:land	freq:2
word:raile	freq:1
word:knowes	freq:4
word:rightly	freq:2
word:than	freq:1
word:iumpe	freq:1
word:suffer	freq:2
word:venetian	freq:1
word:autumne	freq:1
word:that	freq:1
word:truth	freq:8
word:vnhappy	freq:1
word:asses	freq:1
word:left	freq:8
word:caught	freq:1
word:defending	freq:1
word:boxe	freq:1
word:tents	freq:1
word:doe	freq:10
word:writes	freq:1
word:dog	freq:5
word:court	freq:1
word:aliue	freq:2
word:who	freq:1
word:vndersaile	freq:1
word:sonne	freq:8
word:garded	freq:1
word:enioying	freq:1
word:terme	freq:1
word:ergo	freq:1
word:why	freq:1
word:vnlessoned	freq:1
word:deuice	freq:1
word:denie	freq:6
word:harsh	freq:1
word:humblenesse	freq:2
word:forfeite	freq:2
word:grandsire	freq:1
word:presume	freq:1
word:care	freq:3
word:hoode	freq:1
word:themselues	freq:4
word:legs	freq:1
word:surfeit	freq:1
word:whether	freq:1
word:garnish	freq:1
word:grati	freq:1
word:wherefore	freq:1
word:much	freq:48
word:wil	freq:5
word:win	freq:3
word:neede	freq:2
word:throughfares	freq:1
word:sitting	freq:1
word:outcries	freq:1
word:teaches	freq:2
word:thrice	freq:6
word:wit	freq:8
word:needs	freq:2
word:timber	freq:1
word:sufferance	freq:1
word:gracious	freq:2
word:obdurate	freq:1
word:beach	freq:1
word:chests	freq:1
word:powers	freq:1
word:raine	freq:2
word:thanked	freq:1
word:strangers	freq:2
word:paltry	freq:1
word:aduersary	freq:1
word:broth	freq:1
word:iaundies	freq:1
word:purchasing	freq:1
word:graue	freq:2
word:quartus	freq:1
word:hid	freq:3
word:hie	freq:2
word:matcht	freq:1
word:worke	freq:3
word:thankes	freq:1
word:vntil	freq:1
word:protest	freq:1
word:him	freq:110
word:lan	freq:1
word:skilfull	freq:1
word:hasted	freq:1
word:hip	freq:2
word:error	freq:2
word:his	freq:16
word:moneyes	freq:4
word:hit	freq:2
word:moroco	freq:1
word:lau	freq:1
word:traffiquers	freq:1
word:discouery	freq:1
word:portia	freq:1
word:shaft	freq:1
word:law	freq:1
word:cast	freq:1
word:lay	freq:5
word:grieu	freq:1
word:passion	freq:2
word:likest	freq:1
word:monarch	freq:1
word:honored	freq:1
word:decay	freq:1
word:spoke	freq:5
word:world	freq:15
word:enow	freq:1
word:cato	freq:1
word:dri	freq:1
word:glasse	freq:2
word:thee	freq:65
word:imagin	freq:1
word:turned	freq:1
word:fearefully	freq:1
word:pace	freq:1
word:liberall	freq:3
word:shedding	freq:1
word:egal	freq:1
word:them	freq:42
word:backeward	freq:1
word:then	freq:2
word:misfortune	freq:2
word:turnes	freq:1
word:coyne	freq:1
word:dry	freq:1
word:comming	freq:5
word:slaughter	freq:1
word:solemnize	freq:1
word:vsurer	freq:1
word:vrgest	freq:1
word:they	freq:14
word:easier	freq:1
word:bellarioes	freq:1
word:ther	freq:1
word:window	freq:1
word:arrow	freq:1
word:greeuous	freq:1
word:smell	freq:1
word:cooled	freq:2
word:countrimen	freq:1
word:rather	freq:12
word:iust	freq:2
word:pines	freq:1
word:balthasar	freq:1
word:write	freq:1
word:questions	freq:1
word:inscriptions	freq:1
word:praier	freq:1
word:dst	freq:1
word:asham	freq:1
word:bankes	freq:1
word:godfathers	freq:1
word:doctors	freq:1
word:medea	freq:1
word:looke	freq:9
word:wren	freq:1
word:gage	freq:1
word:thrift	freq:3
word:madame	freq:1
word:curtaines	freq:2
word:last	freq:8
word:fond	freq:2
word:diuers	freq:1
word:motions	freq:1
word:glory	freq:1
word:reproach	freq:1
word:leadest	freq:1
word:worne	freq:1
word:craue	freq:1
word:sum	freq:4
word:lookt	freq:1
word:rush	freq:1
word:breake	freq:9
word:tearmes	freq:3
word:account	freq:3
word:sup	freq:1
word:seruice	freq:4
word:hardly	freq:1
word:question	freq:6
word:obliged	freq:1
word:bragging	freq:2
word:late	freq:3
word:relent	freq:1
word:sodainlie	freq:1
word:sun	freq:1
word:font	freq:1
word:lately	freq:1
word:falling	freq:1
word:raisd	freq:1
word:raise	freq:5
word:bassanios	freq:1
word:denying	freq:1
word:food	freq:1
word:narrow	freq:2
word:led	freq:1
word:due	freq:3
word:shouldst	freq:1
word:naughtie	freq:1
word:tweene	freq:1
word:breede	freq:2
word:duk	freq:1
word:prosper	freq:1
word:portly	freq:1
word:duke	freq:1
word:let	freq:1
word:priuately	freq:1
word:waters	freq:4
word:tarters	freq:1
word:foot	freq:1
word:bloods	freq:1
word:odde	freq:1
word:faults	freq:1
word:perswade	freq:1
word:laun	freq:1
word:promis	freq:1
word:repaie	freq:1
word:lies	freq:4
word:strongly	freq:1
word:howling	freq:1
word:brothers	freq:1
word:treasure	freq:1
word:bloody	freq:1
word:danger	freq:3
word:liew	freq:1
word:lodging	freq:4
word:enuy	freq:1
word:feede	freq:5
word:won	freq:4
word:woo	freq:1
word:suited	freq:1
word:houell	freq:1
word:fourth	freq:1
word:sailes	freq:1
word:lend	freq:9
word:life	freq:22
word:hiue	freq:1
word:couered	freq:1
word:dreaming	freq:1
word:leapes	freq:1
word:signor	freq:1
word:dull	freq:4
word:leading	freq:1
word:this	freq:13
word:lieu	freq:1
word:drowning	freq:1
word:preparation	freq:1
word:giddie	freq:1
word:writ	freq:2
word:squandred	freq:1
word:hoa	freq:1
word:l[ord]	freq:1
word:woollen	freq:1
word:abide	freq:2
word:hoe	freq:2
word:knowne	freq:3
word:famisht	freq:1
word:carrion	freq:3
word:stirring	freq:1
word:faile	freq:6
word:charter	freq:1
word:contending	freq:1
word:seruants	freq:3
word:ague	freq:1
word:exact	freq:2
word:contain	freq:1
word:rancke	freq:1
word:ostent	freq:1
word:hot	freq:2
word:appeares	freq:4
word:close	freq:2
word:how	freq:1
word:poore	freq:12
word:elbow	freq:1
word:diuine	freq:1
word:leon	freq:1
word:drunke	freq:1
word:strumpet	freq:2
word:shalt	freq:10
word:meanes	freq:11
word:ancient	freq:3
word:voyce	freq:2
word:almost	freq:4
word:fore	freq:2
word:issue	freq:2
word:certainty	freq:1
word:heresie	freq:1
word:shewed	freq:1
word:shall	freq:5
word:needes	freq:2
word:deriu	freq:1
word:citty	freq:1
word:example	freq:2
word:noble	freq:7
word:braine	freq:1
word:greefes	freq:1
word:neats	freq:1
word:patience	freq:2
word:impenetrable	freq:1
word:rough	freq:2
word:questionlesse	freq:1
word:certainely	freq:3
word:pleasantry	freq:1
word:mannage	freq:1
word:shake	freq:1
word:allowes	freq:1
word:strond	freq:1
word:shame	freq:3
word:balthaser	freq:1
word:consider	freq:1
word:states	freq:1
word:faild	freq:1
word:saxonies	freq:1
word:skip	freq:1
word:deuill	freq:1
word:motion	freq:2
word:shewes	freq:2
word:lie	freq:2
word:ostents	freq:1
word:dye	freq:1
word:commits	freq:1
word:worse	freq:5
word:wealth	freq:8
word:royal	freq:1
word:paid	freq:3
word:boords	freq:1
word:featherbed	freq:1
word:india	freq:1
word:silkes	freq:1
word:curtsie	freq:2
word:flocke	freq:1
word:cause	freq:5
word:sport	freq:2
word:sayings	freq:1
word:wry	freq:1
word:tawnie	freq:1
word:pay	freq:6
word:worst	freq:3
word:faint	freq:1
word:better	freq:21
word:spider	freq:1
word:exclaime	freq:1
word:intercessors	freq:1
word:dutie	freq:1
word:faine	freq:1
word:father	freq:4
word:wench	freq:1
word:hudled	freq:1
word:church	freq:1
word:lookes	freq:3
word:iewes	freq:1
word:wiues	freq:6
word:catercosins	freq:1
word:vsances	freq:1
word:worth	freq:8
word:conueniencie	freq:1
word:finger	freq:5
word:shadowed	freq:1
word:sepulcher	freq:1
word:riueted	freq:1
word:controuersie	freq:1
word:abate	freq:1
word:beauties	freq:1
word:pleasure	freq:2
word:philhorse	freq:1
word:acquaintance	freq:1
word:carthage	freq:1
word:accoutered	freq:1
word:ignorant	freq:1
word:shadowes	freq:2
word:penaltie	freq:2
word:smile	freq:1
word:suffice	freq:2
word:intent	freq:1
word:power	freq:11
word:midas	freq:1
word:troian	freq:1
word:a	freq:12
word:which	freq:1
word:d	freq:126
word:shape	freq:1
word:e	freq:1
word:four	freq:3
word:assumes	freq:1
word:like	freq:9
word:i	freq:1
word:depart	freq:1
word:pale	freq:1
word:l	freq:2
word:n	freq:1
word:anone	freq:3
word:demurely	freq:1
word:o	freq:1
word:s	freq:44
word:t	freq:5
word:loose	freq:11
word:blinde	freq:6
word:clown	freq:1
word:sorry	freq:3
word:intirely	freq:1
word:apparrell	freq:1
word:imploy	freq:1
word:shortly	freq:2
word:rendring	freq:1
word:shortlie	freq:1
word:quietnesse	freq:1
word:candell	freq:1
word:feard	freq:2
word:feare	freq:15
word:brightly	freq:1
word:regard	freq:1
word:wants	freq:2
word:fancie	freq:1
word:inchanted	freq:1
word:argos	freq:1
word:hoope	freq:1
word:threshold	freq:1
word:act	freq:1
word:keyes	freq:1
word:toward	freq:4
word:phoebus	freq:1
word:knowst	freq:1
word:vnburthen	freq:1
word:thou	freq:3
word:multitude	freq:2
word:breast	freq:1
word:warme	freq:1
word:scripture	freq:1
word:wearies	freq:2
word:fortunes	freq:4
word:pleased	freq:1
word:witnesse	freq:2
word:hue	freq:2
word:successe	freq:1
word:gratis	freq:3
word:sence	freq:1
word:musique	freq:6
word:faire	freq:1
word:through	freq:3
word:latine	freq:1
word:coales	freq:1
word:returne	freq:7
word:footing	freq:1
word:breath	freq:5
word:approach	freq:2
word:ado	freq:1
word:spirits	freq:3
word:bargaine	freq:1
word:hudg	freq:1
word:pen	freq:1
word:bleeding	freq:1
word:behinde	freq:3
word:feast	freq:4
word:customary	freq:1
word:heauinesse	freq:1
word:organs	freq:1
word:saylers	freq:1
word:neere	freq:5
word:pittie	freq:1
word:round	freq:2
word:reinish	freq:1
word:spunge	freq:1
word:after	freq:1
word:lower	freq:1
word:soft	freq:3
word:feele	freq:1
word:owes	freq:1
word:odly	freq:1
word:mallice	freq:1
word:wager	freq:2
word:gathered	freq:1
word:line	freq:1
word:vntread	freq:1
word:assur	freq:2
word:digest	freq:1
word:match	freq:2
word:gard	freq:1
word:palenesse	freq:1
word:daughter	freq:20
word:obtained	freq:1
word:naughty	freq:2
word:palentine	freq:1
word:debter	freq:1
word:forgaue	freq:1
word:iniunctions	freq:1
word:moath	freq:1
word:beneath	freq:1
word:difference	freq:4
word:beard	freq:2
word:beare	freq:7
word:faith	freq:11
word:lor	freq:1
word:lewd	freq:1
word:adde	freq:1
word:lou	freq:5
word:sometimes	freq:1
word:low	freq:4
word:blow	freq:2
word:deuise	freq:1
word:sentence	freq:3
word:lion	freq:1
word:teaching	freq:2
word:brassie	freq:1
word:damned	freq:2
word:iessi	freq:1
word:estates	freq:1
word:wagge	freq:1
word:vnhandled	freq:1
word:affection	freq:5
word:age	freq:2
word:esteem	freq:1
word:cackling	freq:1
word:childe	freq:4
word:vnpractiz	freq:1
word:exceeding	freq:2
word:greatnesse	freq:1
word:huge	freq:1
word:flat	freq:1
word:cruell	freq:2
word:must	freq:10
word:temples	freq:1
word:because	freq:1
word:fashion	freq:3
word:choise	freq:3
word:bags	freq:2
word:purchast	freq:3
word:gusts	freq:1
word:tuball	freq:1
word:beast	freq:1
word:lips	freq:2
word:thanke	freq:10
word:learning	freq:3
word:adew	freq:1
word:pickt	freq:1
word:doore	freq:2
word:eloquence	freq:1
word:praise	freq:5
word:pettie	freq:1
word:tak	freq:1
word:embraced	freq:2
word:pil	freq:1
word:claime	freq:2
word:mates	freq:1
word:thanks	freq:1
word:proued	freq:1
word:valiant	freq:1
word:contemplation	freq:1
word:bosomes	freq:1
word:gate	freq:3
word:exaction	freq:1
word:temporall	freq:1
word:creature	freq:2
word:stoopes	freq:1
word:shift	freq:1
word:excrement	freq:1
word:contrary	freq:2
word:readie	freq:1
word:cite	freq:1
word:gaue	freq:10
word:part	freq:19
word:dreame	freq:1
word:crisped	freq:1
word:impugne	freq:1
word:stole	freq:1
word:torment	freq:1
word:gelt	freq:1
word:where	freq:5
word:fretted	freq:1
word:baite	freq:3
word:thriue	freq:2
word:vantage	freq:1
word:doost	freq:3
word:yeelde	freq:1
word:bain	freq:1
word:exploit	freq:1
word:curtesie	freq:3
word:endlesse	freq:1
word:thus	freq:8
word:angell	freq:1
word:compremyz	freq:1
word:past	freq:1
word:releefe	freq:1
word:gratifie	freq:1
word:rouse	freq:1
word:sabbath	freq:1
word:bidding	freq:1
word:confession	freq:1
word:repent	freq:1
word:beene	freq:10
word:religion	freq:1
word:torturest	freq:1
word:sola	freq:1
word:studied	freq:1
word:dumbe	freq:3
word:into	freq:1
word:bouge	freq:3
word:sold	freq:1
word:scale	freq:1
word:peales	freq:1
word:gift	freq:4
word:reuerence	freq:3
word:losse	freq:3
word:fairer	freq:3
word:plague	freq:1
word:away	freq:4
word:woluish	freq:1
word:somewhat	freq:1
word:lingring	freq:1
word:obscur	freq:1
word:ocean	freq:1
word:groomes	freq:1
word:excesse	freq:2
word:while	freq:7
word:batcheler	freq:1
word:stone	freq:1
word:gentle	freq:4
word:ratified	freq:1
word:serpent	freq:1
word:fled	freq:1
word:issuing	freq:1
word:cheefe	freq:1
word:pied	freq:1
word:pigge	freq:1
word:neerest	freq:1
word:mansion	freq:1
word:golden	freq:6
word:some	freq:4
word:wooer	freq:1
word:ladie	freq:1
word:directed	freq:2
word:villaines	freq:1
word:deface	freq:1
word:content	freq:5
word:wisely	freq:1
word:doores	freq:2
word:dram	freq:1
word:solyman	freq:1
word:although	freq:1
word:stood	freq:1
word:attendeth	freq:1
word:flew	freq:1
word:draw	freq:9
word:gently	freq:1
word:cheer	freq:1
word:repaire	freq:1
word:tel	freq:1
word:rigorous	freq:1
word:estimation	freq:3
word:beholding	freq:1
word:deceased	freq:1
word:all	freq:48
word:aske	freq:3
word:mounsier	freq:1
word:liue	freq:14
word:quit	freq:1
word:supplie	freq:1
word:epitaph	freq:1
word:ten	freq:6
word:wrung	freq:1
word:olde	freq:1
word:businesse	freq:2
word:song	freq:1
word:interest	freq:3
word:aboord	freq:1
word:bals	freq:1
word:disgrac	freq:1
word:chang	freq:2
word:applause	freq:1
word:cleare	freq:1
word:besmeare	freq:1
word:depends	freq:1
word:beds	freq:1
word:obserue	freq:1
word:scant	freq:2
word:bassianos	freq:1
word:seauen	freq:1
word:indirectlie	freq:1
word:briefe	freq:3
word:commonwealth	freq:1
word:estate	freq:4
word:paying	freq:1
word:wakes	freq:1
word:hindred	freq:1
word:al	freq:1
word:am	freq:76
word:an	freq:1
word:owne	freq:20
word:betweene	freq:9
word:giuen	freq:4
word:ar	freq:1
word:as	freq:18
word:salanio	freq:1
word:at	freq:16
word:giues	freq:3
word:amorous	freq:1
word:gere	freq:1
word:gaze	freq:2
word:profit	freq:2
word:ferrie	freq:1
word:vntill	freq:2
word:conceauing	freq:1
word:reason	freq:10
word:treads	freq:1
word:been	freq:1
word:furthermore	freq:1
word:and	freq:1
word:curteous	freq:3
word:dismisse	freq:1
word:be	freq:23
word:buzzing	freq:1
word:romane	freq:1
word:steale	freq:5
word:found	freq:5
word:por	freq:1
word:instruction	freq:1
word:ant	freq:1
word:pervse	freq:1
word:scape	freq:2
word:riping	freq:1
word:any	freq:24
word:presenting	freq:1
word:brauer	freq:1
word:by	freq:3
word:lawes	freq:1
word:displeasure	freq:1
word:impart	freq:1
word:deliuer	freq:3
word:eaning	freq:1
word:together	freq:5
word:italian	freq:1
word:the	freq:1
word:flie	freq:1
word:stucke	freq:2
word:cubs	freq:1
word:crowned	freq:1
word:taste	freq:2
word:borrowed	freq:2
word:store	freq:2
word:greedy	freq:1
word:hebrew	freq:1
word:payd	freq:1
word:people	freq:2
word:begg	freq:2
word:pretty	freq:2
word:thy	freq:10
word:awak	freq:1
word:iaylor	freq:1
word:suted	freq:1
word:negroes	freq:1
word:swan	freq:1
word:beest	freq:1
word:maide	freq:1
word:gondilo	freq:1
word:light	freq:9
word:meager	freq:1
word:winter	freq:1
word:lye	freq:5
word:nation	freq:1
word:mountferrat	freq:1
word:vnforfaited	freq:1
word:sway	freq:2
word:maids	freq:1
word:enuious	freq:1
word:keep	freq:1
word:til	freq:2
word:holds	freq:2
word:cheeke	freq:2
word:tis	freq:2
word:speake	freq:1
word:take	freq:8
word:ambitious	freq:2
word:do	freq:12
word:sore	freq:1
word:speech	freq:1
word:interior	freq:1
word:keennesse	freq:1
word:drew	freq:1
word:suretie	freq:2
word:du	freq:1
word:blesseth	freq:1
word:winde	freq:9
word:shal	freq:2
word:greefe	freq:1
word:boyes	freq:1
word:cruelty	freq:3
word:sort	freq:3
word:vnwillingly	freq:1
word:aduisedlie	freq:1
word:ciuillitie	freq:1
word:preferment	freq:1
word:vaines	freq:2
word:staind	freq:1
word:presently	freq:6
word:passe	freq:2
word:second	freq:4
word:speede	freq:1
word:heauen	freq:13
word:bound	freq:11
word:boune	freq:1
word:tale	freq:1
word:modestie	freq:2
word:tall	freq:1
word:shylocke	freq:1
word:roring	freq:1
word:notaries	freq:1
word:tales	freq:2
word:rebell	freq:1
word:seeming	freq:1
word:certified	freq:1
word:andrew	freq:1
word:weapons	freq:1
word:ey	freq:1
word:gudgin	freq:1
word:rebels	freq:1
word:canst	freq:3
word:election	freq:2
word:face	freq:7
word:are	freq:2
word:bare	freq:2
word:attempts	freq:1
word:against	freq:5
word:floods	freq:1
word:bookes	freq:1
word:being	freq:5
word:foure	freq:5
word:welcom	freq:2
word:arm	freq:2
word:nerrissa	freq:1
word:supposition	freq:1
word:misse	freq:2
word:princes	freq:1
word:prouided	freq:3
word:ships	freq:3
word:bars	freq:2
word:manners	freq:2
word:dealings	freq:1
word:art	freq:1
word:blessing	freq:5
word:heauens	freq:2
word:hurt	freq:1
word:humane	freq:2
word:since	freq:1
word:incarnation	freq:1
word:luck	freq:1
word:inscription	freq:1
word:louely	freq:1
word:wisest	freq:1
word:white	freq:3
word:turkes	freq:1
word:base	freq:2
word:ich	freq:1
word:throned	freq:1
word:directly	freq:2
word:infaith	freq:1
word:instantly	freq:3
word:sisters	freq:1
word:sadnesse	freq:2
word:tane	freq:3
word:manner	freq:1
word:go	freq:2
word:bass	freq:1
word:portrait	freq:1
word:notwithstanding	freq:2
word:fourescore	freq:3
word:liuerie	freq:1
word:member	freq:1
word:crosse	freq:2
word:alas	freq:4
word:therefore	freq:2
word:learned	freq:6
word:qualifie	freq:1
word:swet	freq:1
word:downe	freq:1
word:ryalta	freq:1
word:spurne	freq:2
word:eu	freq:1
word:ha	freq:4
word:defect	freq:1
word:continuance	freq:1
word:ornament	freq:3
word:cleere	freq:1
word:preuented	freq:1
word:superfluitie	freq:1
word:he	freq:11
word:bell	freq:2
word:longer	freq:3
word:wings	freq:2
word:ryalto	freq:1
word:put	freq:6
word:enforced	freq:2
word:ho	freq:2
word:bids	freq:2
word:company	freq:5
word:bonnet	freq:1
word:simple	freq:4
word:gratianos	freq:1
word:degrees	freq:1
word:humor	freq:1
word:shee	freq:1
word:tarrie	freq:1
word:cleerd	freq:1
word:vrine	freq:1
word:welcome	freq:15
word:turning	freq:1
word:congregate	freq:1
word:snakie	freq:1
word:likes	freq:1
word:lastly	freq:1
word:iealousie	freq:1
word:shew	freq:9
word:noyse	freq:1
word:loathing	freq:1
word:manifest	freq:1
word:if	freq:3
word:wrinkled	freq:1
word:iem	freq:1
word:yeeld	freq:3
word:flor	freq:1
word:padua	freq:1
word:thoughts	freq:7
word:rores	freq:1
word:in	freq:4
word:iet	freq:1
word:ies	freq:1
word:iew	freq:1
word:is	freq:24
word:it	freq:3
word:vndertooke	freq:1
word:sacrifice	freq:2
word:answer	freq:12
word:natiue	freq:1
word:vnhallowed	freq:1
word:reuenge	freq:5
word:open	freq:1
word:courtship	freq:1
word:exprest	freq:3
word:herein	freq:2
word:forgiue	freq:2
word:miles	freq:2
word:end	freq:8
word:fiend	freq:10
word:bend	freq:1
word:soften	freq:1
word:years	freq:1
word:slaue	freq:1
word:too	freq:11
word:top	freq:1
word:rasher	freq:1
word:pipe	freq:2
word:enuies	freq:1
word:bene	freq:2
word:grosenesse	freq:1
word:wretched	freq:1
word:happinesse	freq:1
word:other	freq:22
word:nazarite	freq:1
word:fault	freq:3
word:beaten	freq:1
word:snapper	freq:1
word:vrge	freq:2
word:render	freq:5
word:crowne	freq:1
word:paler	freq:1
word:interrest	freq:3
word:vnseale	freq:1
word:antipodes	freq:1
word:shed	freq:1
word:wanted	freq:1
word:protection	freq:1
word:hainous	freq:1
word:hercules	freq:1
word:goods	freq:4
word:awe	freq:1
word:m[aster]	freq:1
word:redeeme	freq:1
word:flood	freq:2
word:builds	freq:1
word:talke	freq:5
word:soone	freq:3
word:cheere	freq:4
word:sings	freq:2
word:adue	freq:4
word:remorse	freq:1
word:heauie	freq:1
word:souldior	freq:1
word:hircanion	freq:1
word:mocker	freq:1
word:months	freq:8
word:cradle	freq:1
word:lying	freq:1
word:pallats	freq:1
word:decrees	freq:1
word:fareyouwell	freq:1
word:speechlesse	freq:1
word:importunity	freq:1
word:penalty	freq:2
word:grecian	freq:1
word:launcelet	freq:1
word:practise	freq:1
word:disabling	freq:1
word:traine	freq:4
word:cupid	freq:1
word:messenger	freq:1
word:iobbe	freq:1
word:neuer	freq:4
word:traind	freq:1
word:le	freq:1
word:edge	freq:1
word:three	freq:3
word:contented	freq:1
word:thriftie	freq:1
word:ll	freq:4
word:wrinckles	freq:1
word:louers	freq:2
word:knowing	freq:1
word:haste	freq:5
word:marriage	freq:4
word:lt	freq:1
word:conuerse	freq:2
word:giue	freq:10
word:meane	freq:1
word:fatall	freq:1
word:none	freq:1
word:lorenso	freq:1
word:ship	freq:7
word:wracke	freq:1
word:bonds	freq:1
word:married	freq:4
word:greene	freq:1
word:liuings	freq:1
word:husbandry	freq:1
word:hadst	freq:1
word:mad	freq:4
word:me	freq:94
word:meant	freq:1
word:hopes	freq:3
word:speak	freq:1
word:man	freq:58
word:necessitie	freq:1
word:iudges	freq:1
word:wrackt	freq:1
word:mo	freq:1
word:tell	freq:3
word:try	freq:1
word:mar	freq:1
word:may	freq:12
word:mak	freq:3
word:tels	freq:1
word:plyes	freq:1
word:my	freq:2
word:bride	freq:1
word:freely	freq:3
word:maine	freq:2
word:bones	freq:1
word:shames	freq:2
word:ere	freq:5
word:faryewell	freq:2
word:kinde	freq:12
word:chest	freq:1
word:speakes	freq:3
word:ne	freq:1
word:drop	freq:3
word:aprill	freq:1
word:blood	freq:8
word:prayer	freq:3
word:findes	freq:1
word:methinkes	freq:2
word:vndervallewd	freq:1
word:scedule	freq:1
word:no	freq:2
word:engendred	freq:1
word:substance	freq:3
word:scrubbed	freq:2
word:child	freq:1
word:yonger	freq:1
word:satisfied	freq:3
word:afterward	freq:1
word:vpright	freq:4
word:curtain	freq:1
word:feeder	freq:1
word:braue	freq:2
word:barraine	freq:1
word:affections	freq:3
word:neyther	freq:1
word:prayes	freq:1
word:contriue	freq:1
word:maister	freq:2
word:seruingman	freq:1
word:depending	freq:1
word:pronounc	freq:1
word:of	freq:2
word:stampe	freq:1
word:fall	freq:3
word:yeere	freq:3
word:nightingale	freq:1
word:on	freq:13
word:fals	freq:2
word:another	freq:10
word:possible	freq:1
word:or	freq:1
word:walkes	freq:1
word:best	freq:9
word:milke	freq:1
word:stampt	freq:1
word:axe	freq:1
word:halfe	freq:14
word:musicke	freq:1
word:tub	freq:1
word:wont	freq:4
word:blotted	freq:1
word:threatnest	freq:1
word:neighbourly	freq:1
word:vnto	freq:2
word:ile	freq:1
word:dulcet	freq:1
word:mountaine	freq:1
word:louing	freq:3
word:iasons	freq:1
word:gurmandize	freq:1
word:happier	freq:1
word:ill	freq:5
word:getting	freq:1
word:force	freq:5
word:wooe	freq:1
word:vncapable	freq:1
word:kept	freq:2
word:youle	freq:2
word:rocks	freq:3
word:tertius	freq:1
word:lyes	freq:1
word:paper	freq:4
word:ranke	freq:1
word:ashamed	freq:1
word:shylockes	freq:1
word:citizen	freq:1
word:meerly	freq:1
word:safelie	freq:1
word:mee	freq:10
word:spurrer	freq:1
word:slew	freq:1
word:misbeleeuer	freq:1
word:chins	freq:1
word:speed	freq:4
word:strain	freq:1
word:trunkes	freq:1
word:men	freq:26
word:glisters	freq:1
word:trebled	freq:1
word:chaffe	freq:2
word:sooth	freq:1
word:mes	freq:1
word:strait	freq:2
word:suruay	freq:1
word:rendred	freq:1
word:laught	freq:1
word:ewes	freq:1
word:monies	freq:1
word:kings	freq:1
word:obtain	freq:2
word:forfeit	freq:7
word:gifts	freq:2
word:rode	freq:1
word:nose	freq:2
word:sinne	freq:3
word:serue	freq:3
word:among	freq:2
word:vndone	freq:1
word:fellowes	freq:3
word:further	freq:1
word:mistres	freq:1
word:re	freq:1
word:pursue	freq:1
word:two	freq:5
word:vehement	freq:1
word:aside	freq:1
word:caskets	freq:2
word:esteemd	freq:1
word:worthier	freq:1
word:slauish	freq:1
word:curb	freq:1
word:defend	freq:1
word:determine	freq:1
word:young	freq:3
word:malice	freq:1
word:note	freq:4
word:shoo	freq:1
word:kill	freq:1
word:companions	freq:1
word:flye	freq:2
word:shot	freq:1
word:ewe	freq:1
word:show	freq:6
word:insculpt	freq:1
word:greets	freq:1
word:maist	freq:3
word:nestor	freq:1
word:honour	freq:7
word:floore	freq:1
word:moues	freq:1
word:barrabas	freq:1
word:word	freq:12
word:ruled	freq:1
word:lychas	freq:1
word:so	freq:1
word:merchants	freq:1
word:iot	freq:1
word:vnquiet	freq:2
word:st	freq:16
word:persian	freq:1
word:drum	freq:1
word:thrust	freq:1
word:without	freq:5
word:ranne	freq:1
word:enter	freq:1
word:wanton	freq:2
word:lorenzo	freq:1
word:ground	freq:3
word:what	freq:2
word:dangerous	freq:3
word:traines	freq:1
word:germaine	freq:1
word:maruellously	freq:1
word:losses	freq:4
word:continent	freq:1
word:estimable	freq:1
word:marquesse	freq:1
word:witness	freq:1
word:maskes	freq:1
word:bloud	freq:7
word:generall	freq:1
word:th	freq:7
word:crying	freq:1
word:drones	freq:1
word:sleepe	freq:2
word:graines	freq:1
word:eson	freq:1
word:to	freq:17
word:costly	freq:1
word:clark	freq:1
word:patiently	freq:1
word:king	freq:1
word:vsance	freq:2
word:greeue	freq:1
word:grauel	freq:1
word:boldest	freq:1
word:ioy	freq:6
word:confirm	freq:1
word:eye	freq:9
word:fare	freq:1
word:tender	freq:2
word:wilfull	freq:2
word:churches	freq:1
word:brest	freq:1
word:scepter	freq:1
word:commanded	freq:1
word:youthful	freq:1
word:profound	freq:1
word:till	freq:1
word:england	freq:1
word:salarino	freq:1
word:slips	freq:1
word:againe	freq:14
word:indirect	freq:1
word:bespeake	freq:1
word:coole	freq:1
word:quarrel	freq:1
word:saluation	freq:1
word:waterie	freq:1
word:bad	freq:3
word:marring	freq:1
word:breeders	freq:1
word:bag	freq:4
word:things	freq:10
word:mistris	freq:2
word:sounds	freq:5
word:time	freq:24
word:awaie	freq:2
word:miseries	freq:1
word:nuptiall	freq:1
word:virgin	freq:1
word:patch	freq:1
word:surfet	freq:1
word:something	freq:5
word:bas	freq:1
word:fast	freq:5
word:sentences	freq:1
word:vp	freq:12
word:vs	freq:30
word:occasion	freq:2
word:bay	freq:1
word:behalfe	freq:1
word:ventures	freq:4
word:deuised	freq:1
word:rightfull	freq:1
word:throw	freq:1
word:daylight	freq:1
word:staffe	freq:3
word:yours	freq:16
word:cosen	freq:1
word:stephen	freq:1
word:prefer	freq:1
word:bird	freq:1
word:bastard	freq:2
word:we	freq:4
word:spare	freq:1
word:fell	freq:5
word:happily	freq:1
word:endeuors	freq:1
word:mortall	freq:1
word:lesse	freq:6
word:agree	freq:1
word:relation	freq:1
word:felt	freq:1
word:lawfully	freq:1
word:vnthrift	freq:1
word:sheepe	freq:1
word:thwarted	freq:1
word:englishman	freq:1
word:deuided	freq:1
word:when	freq:1
word:sultan	freq:1
word:bring	freq:5
word:person	freq:1
word:scapes	freq:1
word:feasting	freq:1
word:credit	freq:2
word:search	freq:3
word:neighbour	freq:2
word:peeuish	freq:1
word:ith	freq:1
word:forbid	freq:2
word:vessels	freq:1
word:hymne	freq:1
word:whet	freq:1
word:deaths	freq:1
word:rating	freq:1
word:decree	freq:2
word:symitare	freq:1
word:fier	freq:1
word:sicke	freq:5
word:merchandize	freq:3
word:sped	freq:1
word:drudge	freq:1
word:gaudie	freq:1
word:salerio	freq:1
word:vessell	freq:2
word:youth	freq:8
word:comparison	freq:1
word:meere	freq:1
word:moneth	freq:1
word:vineger	freq:1
word:shun	freq:1
word:expresly	freq:1
word:perceiue	freq:1
word:spet	freq:3
word:foorth	freq:1
word:shut	freq:2
word:fife	freq:1
word:woolly	freq:1
word:charibdis	freq:1
word:habitation	freq:1
word:wolfe	freq:1
word:moued	freq:1
word:gleaned	freq:1
word:deuision	freq:1
word:enforce	freq:1
word:vailing	freq:1
word:fift	freq:2
word:wo	freq:1
word:wealthy	freq:3
word:conscience	freq:10
word:goose	freq:1
word:prepare	freq:7
word:thinke	freq:24
word:breeding	freq:1
word:oath	freq:9
word:iustice	freq:6
word:innocence	freq:1
word:bottome	freq:1
word:abroad	freq:3
word:loath	freq:1
word:racke	freq:3
word:sighes	freq:1
word:swearing	freq:2
word:spend	freq:2
word:bestow	freq:1
word:bee	freq:2
word:bed	freq:7
word:thinks	freq:1
word:text	freq:1
word:stage	freq:1
word:renew	freq:1
word:refus	freq:1
word:rackt	freq:1
word:sensible	freq:1
word:forme	freq:1
word:wildes	freq:1
word:vnlocke	freq:1
word:accus	freq:1
word:vnknowne	freq:1
word:spent	freq:2
word:neither	freq:10
word:safe	freq:1
word:fields	freq:1
word:meete	freq:6
word:rome	freq:1
word:should	freq:13
word:exchange	freq:1
word:slaues	freq:1
word:coragious	freq:1
word:burgers	freq:1
word:owners	freq:1
word:musitian	freq:1
word:confesse	freq:2
word:slow	freq:1
word:workes	freq:1
word:wedlocke	freq:1
word:meetest	freq:1
word:entertaine	freq:1
word:strict	freq:1
word:north	freq:1
word:forfeitures	freq:1
word:comforts	freq:1
word:teach	freq:7
word:behauiour	freq:2
word:mor	freq:1
word:deliuering	freq:1
word:choyse	freq:2
word:obscure	freq:1
word:summon	freq:1
word:inward	freq:1
word:tells	freq:1
word:smallest	freq:1
word:subiect	freq:2
word:whil	freq:1
word:suite	freq:9
word:answered	freq:3
word:troth	freq:1
word:beg	freq:5
word:stride	freq:1
word:quality	freq:1
word:beames	freq:1
word:stones	freq:5
word:hearbs	freq:1
word:charitie	freq:2
word:staid	freq:2
word:droppeth	freq:1
word:beautifull	freq:1
word:wisdome	freq:1
word:dismaie	freq:1
word:mouthes	freq:1
word:follow	freq:7
word:husband	freq:10
word:speakst	freq:1
word:flints	freq:1
word:slubber	freq:1
word:weather	freq:1
word:grones	freq:1
word:liueries	freq:1
word:oathes	freq:2
word:farewell	freq:2
word:euerie	freq:2
word:perchance	freq:1
word:wrought	freq:1
word:summe	freq:5
word:exhibit	freq:1
word:hermit	freq:1
word:guest	freq:1
word:condition	freq:4
word:pardon	freq:3
word:punie	freq:1
word:stay	freq:10
word:parrats	freq:1
word:guild	freq:1
word:wonder	freq:1
word:purpose	freq:6
word:neopolitane	freq:1
word:chappels	freq:1
word:farther	freq:2
word:hiding	freq:1
word:oppose	freq:1
word:sight	freq:1
word:stayes	freq:2
word:enemy	freq:1
word:antho	freq:1
word:starued	freq:1
word:said	freq:3
word:princely	freq:1
word:neopolitans	freq:1
word:commodity	freq:1
word:sirra	freq:3
word:strife	freq:1
word:equall	freq:1
word:signiors	freq:2
word:sutors	freq:1
word:established	freq:1
word:smyth	freq:1
word:curtaine	freq:1
word:faces	freq:1
word:seas	freq:1
word:seat	freq:1
word:bid	freq:8
word:fairely	freq:2
word:vglie	freq:1
word:big	freq:1
word:friend	freq:26
word:wildernesse	freq:1
word:guiled	freq:1
word:chance	freq:1
word:conuerting	freq:1
word:stake	freq:2
word:prouder	freq:1
word:deliuerance	freq:1
word:far	freq:5
word:opens	freq:1
word:fat	freq:1
word:heares	freq:1
word:meeting	freq:1
word:borne	freq:3
word:banke	freq:1
word:nature	freq:4
word:peace	freq:1
word:determinations	freq:1
word:escaped	freq:1
word:course	freq:4
word:coffer	freq:1
word:merrie	freq:4
word:assured	freq:3
word:doctor	freq:1
word:dogs	freq:1
word:hates	freq:1
word:crosses	freq:1
word:lungs	freq:1
word:stale	freq:1
word:chanced	freq:1
word:naught	freq:1
word:president	freq:1
word:frenchman	freq:1
word:mettall	freq:2
word:cowards	freq:1
word:solie	freq:1
word:according	freq:3
word:merrit	freq:2
word:bootlesse	freq:1
word:alreadie	freq:1
word:villaine	freq:2
word:cosins	freq:1
word:stonie	freq:1
word:treasons	freq:1
word:sake	freq:5
word:disguise	freq:1
word:fill	freq:1
word:lisbon	freq:1
word:ifaith	freq:1
word:taking	freq:1
word:frayes	freq:1
word:blesse	freq:3
word:waste	freq:4
word:stubborne	freq:1
word:proue	freq:5
word:whiles	freq:1
word:mercie	freq:5
word:abram	freq:1
word:watrie	freq:1
word:merchant	freq:1
word:doate	freq:1
word:dismayed	freq:1
word:valued	freq:1
word:higher	freq:1
word:euents	freq:1
word:intergatories	freq:1
word:sted	freq:2
word:commendable	freq:2
word:grudge	freq:1
word:spets	freq:1
word:renowned	freq:2
word:sala	freq:1
word:pronounced	freq:1
word:blinking	freq:1
word:slander	freq:1
word:kinder	freq:1
word:sinnes	freq:1
word:threatens	freq:1
word:fancies	freq:1
word:fine	freq:3
word:stand	freq:21
word:monkies	freq:1
word:fence	freq:1
word:ioyes	freq:1
word:girle	freq:3
word:dowrie	freq:1
word:himselfe	freq:12
word:flight	freq:2
word:paied	freq:1
word:salar	freq:1
word:vncheckt	freq:1
word:behold	freq:2
word:forth	freq:10
word:discontinued	freq:1
word:same	freq:17
word:intrap	freq:2
word:passions	freq:2
word:whom	freq:5
word:alacke	freq:1
word:serues	freq:2
word:office	freq:1
word:coffin	freq:1
word:marrie	freq:2
word:mouth	freq:1
word:lottrie	freq:1
word:fed	freq:2
word:maistership	freq:1
word:addrest	freq:1
word:fee	freq:2
word:happy	freq:3
word:pidgions	freq:1
word:shylock	freq:1
word:change	freq:4
word:beggar	freq:1
word:vesture	freq:1
word:sees	freq:1
word:leade	freq:2
word:clocke	freq:4
word:sand	freq:4
word:verie	freq:17
word:figure	freq:1
word:grieue	freq:2
word:few	freq:1
word:picture	freq:3
word:cannot	freq:5
word:ceremonie	freq:1
word:thicke	freq:1
word:supper	freq:5
word:signe	freq:2
word:intergatory	freq:1
word:accordingly	freq:1
word:each	freq:1
word:vnmannerly	freq:1
word:clearke	freq:1
word:forfeiture	freq:7
word:houres	freq:4
word:corage	freq:1
word:doublet	freq:1
word:countrey	freq:1
word:goodsooth	freq:1
word:lyniaments	freq:1
word:possesser	freq:1
word:indeauor	freq:1
word:infuse	freq:1
word:laughable	freq:1
word:vnderprising	freq:1
word:request	freq:2
word:pure	freq:1
word:remember	freq:3
word:primus	freq:1
word:meruaile	freq:1
word:gambols	freq:1
word:indirectly	freq:1
word:iwis	freq:1
word:money	freq:14
word:drops	freq:1
word:cupids	freq:1
word:beware	freq:1
word:boy	freq:2
word:furnisht	freq:1
word:dismay	freq:1
word:bosome	freq:3
word:offend	freq:3
word:fairest	freq:1
word:vnlock	freq:1
word:fire	freq:3
word:sweare	freq:23
word:madnesse	freq:2
word:stare	freq:1
word:running	freq:1
word:moderate	freq:1
word:miscarried	freq:2
word:barke	freq:2
word:taile	freq:3
word:stands	freq:2
word:precious	freq:3
word:offence	freq:1
word:pattens	freq:1
word:squealing	freq:1
word:done	freq:9
word:start	freq:1
word:casket	freq:6
word:seruiture	freq:1
word:fortunate	freq:1
word:dong	freq:2
word:exeunt	freq:1
word:authoritie	freq:1
word:scatter	freq:1
word:quarrels	freq:1
word:recorded	freq:1
word:stephano	freq:1
word:others	freq:2
word:conspired	freq:1
word:despaire	freq:1
word:fia	freq:1
word:contents	freq:1
word:treason	freq:3
word:fie	freq:2
word:followers	freq:1
word:fish	freq:2
word:curtesies	freq:2
word:stick	freq:1
word:commands	freq:1
word:begger	freq:2
word:france	freq:1
word:endimion	freq:1
word:opposed	freq:1
word:backe	freq:6
word:solemniz	freq:1
word:humbly	freq:1
word:goodwins	freq:1
word:discourse	freq:1
word:enrobe	freq:1
word:scull	freq:1
word:puts	freq:1
word:muddy	freq:1
word:colde	freq:1
word:fit	freq:1
word:sencible	freq:1
word:aduenturing	freq:1
word:turne	freq:6
word:wedding	freq:1
word:hellish	freq:1
word:venus	freq:1
word:cobwebs	freq:1
word:state	freq:5
word:enioy	freq:1
word:desirest	freq:1
word:thawes	freq:1
word:franckford	freq:1
word:buried	freq:1
word:either	freq:2
word:melancholly	freq:1
word:grauity	freq:1
word:employ	freq:1
word:pyrats	freq:1
word:twenty	freq:3
word:whispring	freq:1
word:euermore	freq:2
word:yonder	freq:2
word:prayers	freq:2
word:priuie	freq:1
word:keeping	freq:1
word:walke	freq:2
word:ducat	freq:1
word:vnbated	freq:1
word:fiue	freq:1
word:multitudes	freq:1
word:corners	freq:2
word:mone	freq:2
word:faster	freq:1
word:mong	freq:1
word:delight	freq:2
word:quicke	freq:1
word:else	freq:9
word:penthouse	freq:1
word:obscures	freq:1
word:thisbie	freq:1
word:assume	freq:2
word:predicament	freq:1
word:monie	freq:1
word:minsing	freq:1
word:helpe	freq:2
word:side	freq:2
word:sweate	freq:1
word:suspect	freq:1
word:wheate	freq:1
word:deseru	freq:2
word:argosies	freq:1
word:sell	freq:2
word:yea	freq:2
word:sauage	freq:1
word:interpreter	freq:1
word:summarie	freq:1
word:spring	freq:1
word:searcht	freq:1
word:amaz	freq:1
word:desert	freq:1
word:farre	freq:6
word:extreamest	freq:1
word:schoole	freq:2
word:hollowing	freq:1
word:vncle	freq:1
word:yes	freq:1
word:flo	freq:1
word:vttermost	freq:2
word:walls	freq:1
word:yet	freq:11
word:lambe	freq:1
word:baron	freq:1
word:infinite	freq:1
word:borrow	freq:2
word:saue	freq:2
word:warmed	freq:1
word:variable	freq:1
word:following	freq:1
word:virgine	freq:1
word:breathing	freq:3
word:bleared	freq:1
word:inserted	freq:1
word:matter	freq:6
word:conceiue	freq:1
word:lambs	freq:1
word:offers	freq:2
word:cornets	freq:1
word:necessarie	freq:1
word:waft	freq:1
word:supply	freq:1
word:meshes	freq:1
word:margerie	freq:1
word:virgins	freq:1
word:grau	freq:1
word:grat	freq:1
word:roome	freq:1
word:doing	freq:3
word:graz	freq:1
word:fledg	freq:1
word:paine	freq:1
word:railes	freq:1
word:foode	freq:1
word:elder	freq:1
word:worthinesse	freq:1
word:snore	freq:1
word:but	freq:1
word:english	freq:1
word:touch	freq:3
word:supposed	freq:1
word:buy	freq:3
word:treble	freq:1
word:waiting	freq:1
word:stop	freq:4
word:orpheus	freq:1
word:consisteth	freq:1
word:creditor	freq:1
word:wouldst	freq:1
word:riseth	freq:1
word:aloofe	freq:2
word:send	freq:3
word:sent	freq:3
word:bethinke	freq:2
word:rings	freq:1
word:dost	freq:5
word:excellent	freq:1
word:clarke	freq:1
word:conceits	freq:1
word:lucke	freq:3
word:wounds	freq:1
word:sought	freq:1
word:teare	freq:1
word:soale	freq:1
word:praying	freq:1
word:steps	freq:1
word:storme	freq:1
word:kneeles	freq:1
word:rodes	freq:1
word:iudge	freq:1
word:fifteene	freq:1
word:sigh	freq:3
word:hazard	freq:11
word:fraught	freq:1
word:doth	freq:6
word:vndeserued	freq:1
word:sign	freq:1
word:fleet	freq:2
word:seasons	freq:1
word:seuerall	freq:1
word:necke	freq:1
word:stocke	freq:1
word:skarfed	freq:1
word:often	freq:3
word:more	freq:16
word:tucket	freq:1
word:painter	freq:1
word:ciuill	freq:1
word:barre	freq:3
word:obey	freq:1
word:warning	freq:1
word:flourish	freq:1
word:neckt	freq:1
word:fortune	freq:8
word:for	freq:3
word:leane	freq:1
word:waie	freq:3
word:amen	freq:1
word:indeed	freq:3
word:withall	freq:7
word:atchieu	freq:1
word:requite	freq:1
word:descend	freq:1
word:royall	freq:1
word:hearst	freq:1
word:pray	freq:33
word:nerissa	freq:1
word:direction	freq:2
word:reddest	freq:1
word:wait	freq:1
word:sences	freq:1
word:heauenly	freq:2
word:portias	freq:1
word:alone	freq:4
word:swore	freq:3
word:along	freq:3
word:ceases	freq:1
word:gentlenesse	freq:1
word:scroule	freq:3
word:quallitie	freq:1
word:charge	freq:4
word:grieuing	freq:1
word:hearts	freq:6
word:most	freq:2
word:bereft	freq:1
word:heede	freq:1
word:confusd	freq:1
word:gree	freq:1
word:steru	freq:1
word:clamber	freq:1
word:smal	freq:1
word:trade	freq:1
word:hogs	freq:1
word:therein	freq:2
word:guilty	freq:1
word:name	freq:9
word:whilst	freq:2
word:immediately	freq:1
word:twentieth	freq:1
word:grandam	freq:1
word:planted	freq:1
word:formerly	freq:1
word:need	freq:1
word:accident	freq:1
word:speciall	freq:1
word:scuse	freq:1
word:clarks	freq:1
word:harmonie	freq:2
word:blame	freq:2
word:warrant	freq:1
word:leape	freq:1
word:description	freq:2
word:instant	freq:2
word:nay	freq:1
word:piper	freq:1
word:husbands	freq:8
word:italie	freq:1
word:down	freq:1
word:voluntarie	freq:1
word:become	freq:2
word:sweete	freq:4
word:aduantage	freq:1
word:fauconbridge	freq:1
word:purse	freq:3
word:crow	freq:1
word:seru	freq:2
word:moue	freq:1
word:shrine	freq:1
word:coach	freq:1
word:offered	freq:1
word:still	freq:1
word:graces	freq:1
word:worthie	freq:1
word:proofe	freq:1
word:wearer	freq:1
word:hither	freq:1
word:anthonio	freq:1
word:denied	freq:1
word:approue	freq:1
word:blisse	freq:2
word:million	freq:1
word:halter	freq:2
word:tainted	freq:2
word:regreets	freq:1
word:wall	freq:1
word:vsuall	freq:1
word:commendation	freq:1
word:belmont	freq:1
word:whiter	freq:1
word:wake	freq:1
word:watch	freq:1
word:generation	freq:1
word:enioynd	freq:1
word:doite	freq:1
word:inhumane	freq:1
word:gouern	freq:1
word:wooers	freq:1
word:desire	freq:11
word:shrewd	freq:1
word:ladies	freq:1
word:deliberate	freq:1
word:eare	freq:4
word:approaching	freq:1
word:vowes	freq:1
word:twice	freq:3
word:capring	freq:1
word:brooke	freq:2
word:authority	freq:1
word:awards	freq:2
word:lotterie	freq:1
word:merriment	freq:1
word:loosers	freq:1
word:follies	freq:1
word:deale	freq:1
word:learn	freq:1
word:deede	freq:1
word:return	freq:3
word:murder	freq:1
word:emptie	freq:1
word:sleepes	freq:3
word:bringeth	freq:1
word:finde	freq:16
word:goodly	freq:1
word:earthly	freq:2
word:animals	freq:1
word:sting	freq:1
word:amis	freq:1
word:plaies	freq:1
word:deeds	freq:2
word:stealing	freq:1
word:grossely	freq:1
word:indian	freq:1
word:substitute	freq:1
word:modest	freq:1
word:reuerend	freq:2
word:argosie	freq:1
word:parted	freq:2
word:gaberdine	freq:1
word:direct	freq:2
word:ordered	freq:1
word:laban	freq:1
word:manie	freq:2
word:between	freq:1
word:least	freq:5
word:want	freq:1
word:stranger	freq:2
word:destinies	freq:1
word:expires	freq:1
word:wisht	freq:1
word:water	freq:2
word:mannerly	freq:1
word:prophet	freq:1
word:occasions	freq:1
word:eate	freq:2
word:ner	freq:1
word:wrong	freq:13
word:foole	freq:9
word:hold	freq:9
word:hether	freq:1
word:new	freq:1
word:honourable	freq:3
word:sing	freq:4
word:possest	freq:3
word:loued	freq:1
word:possess	freq:1
word:forward	freq:1
word:flats	freq:1
word:barbary	freq:1
word:loaths	freq:1
word:exceed	freq:1
word:race	freq:1
word:ouer	freq:5
word:prince	freq:1
word:wearie	freq:1
word:perswaded	freq:1
word:searecloath	freq:1
word:mocke	freq:1
word:profitable	freq:1
word:loues	freq:2
word:month	freq:3
word:counsaile	freq:5
word:holy	freq:7
word:bleede	freq:2
word:louer	freq:2
word:infidell	freq:2
word:those	freq:6
word:peepe	freq:1
word:you	freq:10
word:turn	freq:3
word:troubled	freq:1
word:vnthriftie	freq:1
word:brings	freq:3
word:wooing	freq:1
word:heard	freq:9
word:heare	freq:13
word:counsailes	freq:1
word:eies	freq:6
word:home	freq:8
word:accomplished	freq:1
word:exhortation	freq:1
word:beshrew	freq:1
word:guilded	freq:1
word:nice	freq:1
word:dagger	freq:2
word:peoples	freq:1
word:leaue	freq:4
word:weeping	freq:1
word:couching	freq:1
word:discharge	freq:2
word:heart	freq:18
word:binde	freq:1
word:daniel	freq:1
word:written	freq:1
word:greatest	freq:1
word:scilla	freq:1
word:silence	freq:1
word:teeth	freq:1
word:reputed	freq:1
word:glancing	freq:1
word:harbour	freq:1
word:loosing	freq:1
word:willow	freq:1
word:booke	freq:1
word:creame	freq:1
word:mockt	freq:1
word:haire	freq:4
word:maiestie	freq:1
word:gouerne	freq:1
word:sweeter	freq:1
word:concord	freq:1
word:contriu	freq:1
word:carrie	freq:1
word:selfe	freq:38
word:indies	freq:1
word:desired	freq:1
word:commends	freq:1
word:anthonios	freq:1
word:knew	freq:5
word:trusted	freq:2
word:french	freq:1
word:manly	freq:2
word:peere	freq:1
word:hood	freq:2
word:faryouwell	freq:1
word:dobbins	freq:1
word:woman	freq:1
word:desires	freq:3
word:ward	freq:1
word:maskers	freq:1
word:deserts	freq:2
word:heate	freq:2
word:vertues	freq:2
word:affaires	freq:1
word:vndervalued	freq:1
word:duckets	freq:1
word:peers	freq:1
word:daughters	freq:2
word:extasie	freq:1
word:monster	freq:1
word:tediousnesse	freq:1
word:praie	freq:2
word:ruine	freq:3
word:alwaies	freq:1
word:appetite	freq:1
word:sustaine	freq:1
word:shriue	freq:1
word:deserue	freq:5
word:knows	freq:1
word:dignitie	freq:1
word:ran	freq:1
word:voyd	freq:1
word:table	freq:4
word:empty	freq:1
word:doubt	freq:5
word:hope	freq:12
word:rat	freq:1
word:finis	freq:1
word:skipping	freq:1
word:raw	freq:1
word:infinitely	freq:1
word:exit	freq:1
word:promise	freq:5
word:barely	freq:1
word:periurie	freq:1
word:followed	freq:1
word:deare	freq:1
word:mules	freq:1
word:petty	freq:1
word:rage	freq:3
word:poesie	freq:1
word:pouerty	freq:1
word:shrow	freq:1
word:yesterday	freq:1
word:manna	freq:1
word:absent	freq:2
word:sins	freq:1
word:full	freq:8
word:follower	freq:2
word:followes	freq:2
word:outragious	freq:1
word:ragged	freq:1
word:heauy	freq:1
word:colour	freq:2
word:vnpleasant	freq:1
word:can	freq:3
word:cal	freq:1
word:twere	freq:2
word:plucke	freq:3
word:wide	freq:2
word:cat	freq:1
word:outside	freq:2
word:trees	freq:2
word:well	freq:1
word:prating	freq:1
word:faithlesse	freq:1
word:whereby	freq:1
word:colts	freq:1
word:redoubted	freq:1
word:blent	freq:1
word:arabia	freq:1
word:mending	freq:1
word:germanie	freq:1
word:confusions	freq:1
word:reasons	freq:1
word:masters	freq:2
word:grow	freq:7
word:theeues	freq:3
word:afeard	freq:1
word:single	freq:1
word:pageants	freq:1
word:phylosopher	freq:1
word:pound	freq:11
word:cottages	freq:1
word:lading	freq:1
word:lock	freq:1
word:warmth	freq:1
word:attribute	freq:2
word:ginger	freq:1
word:aduice	freq:1
word:vildely	freq:2
word:adiew	freq:1
word:execute	freq:1
word:calls	freq:2
word:making	freq:2
word:sits	freq:2
word:streakt	freq:1
word:rotten	freq:1
word:prolixity	freq:1
word:inexecrable	freq:1
word:death	freq:11
word:masking	freq:1
word:presage	freq:1
word:tossing	freq:1
word:commoditie	freq:1
word:proceed	freq:1
word:swayes	freq:1
word:doues	freq:1
word:flesh	freq:23
word:christians	freq:1
word:hose	freq:1
word:wife	freq:10
word:orderly	freq:1
word:confusion	freq:1
word:ladiship	freq:1
word:lodg	freq:1
word:twill	freq:1
word:vnworthier	freq:1
word:conueniently	freq:1
word:order	freq:1
word:plaine	freq:7
word:allay	freq:2
word:sinagogue	freq:1
word:perrill	freq:1
word:yeares	freq:1
word:women	freq:1
word:absence	freq:3
word:letters	freq:1
word:bred	freq:4
word:martlet	freq:1
word:went	freq:1
word:countie	freq:1
word:red	freq:1
word:title	freq:2
word:gaines	freq:1
word:receite	freq:1
word:happie	freq:1
word:gesse	freq:1
word:nerrissas	freq:1
word:alcides	freq:1
word:seekes	freq:1
word:marchants	freq:1
word:foote	freq:3
word:repents	freq:1
word:bellowing	freq:1
word:besides	freq:1
word:gazing	freq:2
word:intreate	freq:2
word:prop	freq:3
word:beloued	freq:1
word:streame	freq:2
word:miserie	freq:1
word:armie	freq:1
word:prou	freq:1
word:bloudy	freq:1
word:shewing	freq:1
word:double	freq:2
word:nere	freq:6
word:receiue	freq:3
word:bleate	freq:1
word:trial	freq:1
word:lightest	freq:1
word:bearers	freq:1
word:imputation	freq:1
word:respectiue	freq:1
word:deserues	freq:6
word:refuse	freq:5
word:waies	freq:4
word:honest	freq:12
word:doubly	freq:1
word:taught	freq:1
word:begin	freq:1
word:gossip	freq:1
word:heere	freq:3
word:bodie	freq:3
word:marke	freq:1
word:acquitted	freq:2
word:throwes	freq:1
word:tribe	freq:1
word:abode	freq:1
word:beefes	freq:1
word:gentleman	freq:3
word:tickle	freq:1
word:quaintly	freq:1
word:casualtie	freq:1
word:vtter	freq:1
word:wept	freq:1
word:therfore	freq:1
word:gossips	freq:1
word:imbrac	freq:1
word:learne	freq:3
word:oaths	freq:1
word:shrug	freq:1
word:penance	freq:1
word:kinsman	freq:1
word:brutus	freq:1
word:eares	freq:4
word:fopperie	freq:1
word:able	freq:2
word:nor	freq:2
word:not	freq:16
word:chooseth	freq:11
word:fooles	freq:7
word:now	freq:4
word:vnderstands	freq:1
word:idiot	freq:1
word:mexico	freq:1
word:christning	freq:1
word:heires	freq:1
word:shepheard	freq:1
word:deepe	freq:2
word:lighted	freq:1
word:freedome	freq:2
word:sixe	freq:4
word:appeare	freq:7
word:blest	freq:3
word:suddainely	freq:1
word:semblance	freq:1
word:sweetly	freq:1
word:deseruing	freq:3
word:regarded	freq:1
word:habit	freq:1
word:right	freq:10
word:starue	freq:1
word:signior	freq:1
word:rams	freq:1
word:visited	freq:1
word:worships	freq:2
word:worshipt	freq:1
word:greater	freq:2
word:salino	freq:1
word:afternoone	freq:2
word:were	freq:3
word:forget	freq:1
word:pertaines	freq:1
word:fury	freq:1
word:pleasd	freq:1
word:indeede	freq:4
word:twinkling	freq:1
word:talker	freq:1
word:please	freq:9
word:rib	freq:1
word:maides	freq:1
word:tride	freq:1
word:beshrow	freq:1
word:wert	freq:1
word:bruing	freq:1
word:maiden	freq:1
word:morochus	freq:1
word:dwell	freq:2
word:ducates	freq:1
word:spurn	freq:1
word:maidens	freq:1
word:except	freq:1
word:knowledge	freq:1
word:dwels	freq:3
word:choosing	freq:2
word:heartily	freq:2
word:wherein	freq:1
word:clyme	freq:1
word:laugh	freq:4
word:saies	freq:13
word:embrace	freq:1
word:tailor	freq:1
word:aduised	freq:1
word:sunne	freq:2
word:cold	freq:1
word:bearing	freq:2
word:wilde	freq:6
word:sooner	freq:1
word:forsworne	freq:2
word:nine	freq:2
word:perill	freq:2
word:cutlers	freq:1
word:confound	freq:1
word:readinesse	freq:1
word:christian	freq:1
word:cherubins	freq:1
word:remembred	freq:1
word:gag	freq:1
word:attended	freq:2
word:know	freq:2
word:colt	freq:1
word:dread	freq:2
word:neighing	freq:1
word:sunny	freq:1
word:coast	freq:1
word:deere	freq:2
word:riddance	freq:1
word:haires	freq:2
word:creepe	freq:1
word:tried	freq:2
word:deseruings	freq:2
